┌────────────────────────────────────┐
│                                    │
│         ┌───────┐       ┌────────┐ │
│         └───────┘       │        │ │
│                         │        │ │
│ ┌───────┐               │        │ │
│ │       │               │        │ │
│ │       │               └────────┘ │
│ │       │                          │
│ │       │     ┌──────────────────┐ │
│ │       │     │                  │X│
└─┴───────┴─────┴──────────────────┴─┘